0 0 0 40 0 0 0 0 0 0 0 0 0 0 0 0 0 0 0 0 0 0 0 0 0 0 0 0 0 0 0 0 0 0 0 0 0 0 0 0 0 0 0 0 0 0 0 0 0 0 0 0 0 0 0 0 0 0 0 0 0 0 0 0 0 0 0 0 0 0 0 0 0 0 0 0 0 0 0 0 0 0 0 0 0 0 0 0 0 0 0 0 0 0 0 0 0 0 0 0 0 0 0 0 0 0 0 0 0 0 0 0 0 0 0 0 0 0 0 0 0 0 0 0 0 0 0 0 0 0 0 0 0 0 0 0 0 0 0 0 0 0 93 94 95 96 97 98 0 0 0 0 0 0 0 0 0 0 0 0 0 0 0 0 0 0 0 0 0 0 0 0 0 0 0 0 0 0 0 0 0 0 0 0 0 0 0 0 0 0 0 0 0 0 0 0 0 0 0 0 
0 0 0 0 75 76 77 78 79 80 0 0 0 0 0 0 0 0 0 75 76 77 78 79 80 0 0 0 0 0 28 75 76 77 78 79 80 0 0 0 0 0 0 0 0 0 0 0 75 76 77 78 79 80 0 0 0 0 0 75 76 77 78 79 80 0 0 0 0 0 0 0 0 0 0 0 0 0 0 0 75 76 77 78 79 80 0 0 0 0 0 0 0 0 0 75 76 77 78 79 80 0 0 0 0 0 0 0 0 0 75 76 77 78 79 80 0 0 0 0 0 0 0 0 0 0 0 0 0 0 0 0 0 0 0 0 0 0 0 0 0 0 99 100 101 102 103 104 0 0 0 0 0 0 0 0 0 0 0 0 75 76 77 78 79 80 0 0 0 0 41 0 75 76 77 78 79 80 0 0 0 0 75 76 77 78 79 80 0 0 0 0 0 0 0 0 0 0 0 0 
0 0 0 0 81 82 83 84 85 86 0 0 0 0 0 0 0 0 0 81 82 83 84 85 86 0 0 0 0 0 0 81 82 83 84 85 86 0 0 0 0 0 0 0 0 0 0 0 81 82 83 84 85 86 0 0 0 0 0 81 82 83 84 85 86 0 0 0 0 0 0 0 0 0 0 0 0 0 0 0 81 82 83 84 85 86 28 0 0 0 0 0 0 0 0 81 82 83 84 85 86 0 0 0 0 0 0 0 0 0 81 82 83 84 85 86 0 0 28 0 0 0 0 0 0 0 0 0 0 0 0 0 0 0 0 0 0 0 0 0 0 0 105 106 107 108 109 110 0 0 0 28 0 0 0 0 0 0 0 0 81 82 83 84 85 86 0 0 0 0 0 0 81 82 83 84 85 86 0 0 0 0 81 82 83 84 85 86 0 0 0 0 0 0 0 0 0 0 0 0 
0 0 0 0 87 88 89 90 91 92 0 0 0 0 0 0 0 0 0 87 88 89 90 91 92 0 0 0 0 0 0 87 88 89 90 91 92 0 0 0 0 0 0 0 0 0 0 0 87 88 89 90 91 92 0 0 0 61 0 87 88 89 90 91 92 0 0 0 0 0 0 0 28 0 0 0 0 0 0 0 87 88 89 90 91 92 0 0 0 0 0 0 0 0 0 87 88 89 90 91 92 0 0 0 0 0 0 0 0 0 87 88 89 90 91 92 0 0 0 0 0 0 0 0 0 0 0 0 28 0 0 0 0 0 0 0 0 0 0 0 0 0 111 112 113 114 115 116 0 0 0 0 0 0 0 0 0 0 0 0 87 88 89 90 91 92 0 0 0 0 0 0 87 88 89 90 91 92 0 0 0 0 87 88 89 90 91 92 41 0 0 0 0 0 0 0 0 0 0 0 
0 0 0 0 93 94 95 96 97 98 0 0 0 0 0 0 0 0 0 93 94 95 96 97 98 0 0 0 0 0 0 93 94 95 96 97 98 0 0 0 0 0 0 0 61 0 0 61 93 94 95 96 97 98 0 0 0 0 0 93 94 95 96 97 98 0 0 0 0 0 0 0 0 0 0 0 0 0 0 0 93 94 95 96 97 98 0 0 0 0 0 0 0 0 0 93 94 95 96 97 98 0 28 0 0 0 0 0 0 0 93 94 95 96 97 98 0 0 0 0 0 0 0 0 0 0 0 0 0 0 0 0 0 0 0 0 28 0 0 0 0 0 0 0 0 0 0 0 0 0 0 0 0 0 0 0 0 0 0 0 93 94 95 96 97 98 0 0 0 0 0 0 93 94 95 96 97 98 0 0 0 0 93 94 95 96 97 98 0 0 0 0 0 0 0 0 0 0 0 0 
0 0 0 0 99 100 101 102 103 104 0 0 0 0 47 0 0 0 0 99 100 101 102 103 104 0 0 40 0 0 0 99 100 101 102 103 104 0 0 0 0 0 0 0 0 0 0 0 99 100 101 102 103 104 0 0 0 0 0 99 100 101 102 103 104 0 0 0 0 0 0 0 0 0 0 0 0 0 0 0 99 100 101 102 103 104 0 0 0 0 0 0 0 0 0 99 100 101 102 103 104 0 0 0 0 0 0 0 0 0 99 100 101 102 103 104 0 0 0 0 0 0 0 0 0 0 0 0 0 0 0 0 0 0 0 0 0 0 0 0 0 0 0 0 0 0 0 0 0 0 0 0 0 0 0 0 0 0 0 0 99 100 101 102 103 104 0 0 0 0 0 0 99 100 101 102 103 104 0 0 0 0 99 100 101 102 103 104 0 0 0 0 0 0 0 0 0 0 0 0 
0 0 0 0 105 106 107 108 109 110 0 0 0 0 0 0 0 0 0 105 106 107 108 109 110 0 0 0 0 0 0 105 106 107 108 109 110 0 0 0 0 0 0 0 0 0 0 0 105 106 107 108 109 110 0 0 0 0 0 105 106 107 108 109 110 0 0 0 0 0 0 0 0 0 0 0 0 0 0 0 105 106 107 108 109 110 0 0 0 0 0 0 0 0 0 105 106 107 108 109 110 0 0 0 0 0 0 0 0 0 105 106 107 108 109 110 0 0 0 0 0 0 0 0 0 0 0 0 0 0 0 0 0 0 0 0 0 0 0 0 0 0 0 0 0 0 0 0 0 0 0 0 0 0 0 0 0 0 0 0 105 106 107 108 109 110 0 0 0 0 0 0 105 106 107 108 109 110 0 0 0 0 105 106 107 108 109 110 0 0 0 0 0 0 0 0 0 0 0 0 
0 0 0 0 111 112 113 114 115 116 0 0 0 0 0 0 0 0 0 111 112 113 114 115 116 0 0 0 0 0 61 111 112 113 114 115 116 0 61 28 0 0 0 0 0 0 0 0 111 112 113 114 115 116 0 0 0 0 0 111 112 113 114 115 116 0 0 0 0 0 0 0 0 0 0 0 0 0 0 0 111 112 113 114 115 116 0 0 0 0 0 0 0 0 27 111 112 113 114 115 116 0 0 0 0 0 0 0 0 0 111 112 113 114 115 116 0 0 0 0 0 27 0 0 0 0 0 0 0 0 0 0 0 0 0 0 0 0 0 0 0 0 0 0 0 0 0 0 0 0 0 0 0 0 0 0 0 0 0 0 111 112 113 114 115 116 0 0 0 0 0 0 111 112 113 114 115 116 0 0 0 0 111 112 113 114 115 116 0 0 0 0 0 0 0 27 0 0 0 0 
0 0 0 0 0 0 0 0 0 0 0 0 0 0 0 0 0 0 0 0 0 0 0 0 0 0 0 0 0 0 0 0 0 0 0 0 0 0 0 0 0 0 0 0 0 0 0 0 0 0 0 0 0 0 0 0 0 0 0 0 0 0 0 0 0 0 0 0 0 0 0 0 0 0 0 0 0 0 0 0 0 0 0 0 0 0 0 0 0 0 0 0 0 0 0 0 0 0 0 0 0 0 0 0 0 0 0 0 0 0 0 0 0 0 0 0 0 0 0 0 0 0 0 0 0 0 0 0 0 0 0 0 0 0 0 0 0 0 0 0 0 0 0 0 0 0 0 0 0 0 0 0 0 0 0 0 0 0 0 0 0 0 0 0 0 0 0 0 0 0 0 0 0 0 0 0 0 0 0 0 0 0 0 0 0 0 0 0 0 0 0 0 0 0 0 0 0 0 0 0 
0 0 0 0 0 0 0 0 0 0 0 0 0 0 0 0 0 0 0 0 0 0 0 0 0 0 0 0 0 0 0 0 0 0 0 0 0 0 0 0 0 0 0 0 0 0 0 0 0 0 0 0 0 0 0 0 0 0 0 0 0 0 0 0 0 0 0 0 0 0 0 0 0 0 0 0 0 0 0 0 0 0 0 0 0 0 0 0 0 0 0 0 0 0 0 0 0 0 0 0 0 0 0 0 0 0 0 0 0 0 0 0 0 0 0 0 0 0 0 0 0 0 0 0 0 0 0 0 0 0 0 0 0 0 0 0 0 0 0 0 0 0 0 0 0 0 0 0 0 0 0 0 0 0 0 0 0 0 0 0 0 0 0 0 0 0 0 0 0 0 0 0 0 0 0 0 0 0 0 0 0 0 0 0 0 0 0 0 0 0 0 0 0 0 0 0 0 0 0 0
